################################################################################
#                                                          #                   #
#            @                                                                 #
#                                                       #                      #
#    # #                                             #  ####                   #
#   ##                                              #  ##   #                  #
#                                                   ## #           #           #
#   #                      #     ##                 #   #        #             #
#     #               # #  # # ##                    ## #  #       #           #
#                   #  #   ## ##                   ####    #       ##          #
#                            #   ##             ## #  # #                      #
#                       #   ###                 #                         #    #
#                                            %%%%% #    # #     #  #      #    #
#                        %%%%%               %%%%%%%             ##      # #   #
#                        %%%%%%%            #%%%%%              # #      #     #
#          # #           %%%%% %    #        %%%%%             # # #    #  #   #
#                        %%%%%%%             %%%%% %           # # #           #
#        ##          # # %%% %%%   ##          %%  %                           #
#        ##          #     %%%%  # # #                                         #
#         #                        ##                  #                       #
#                    #     #                       #                           #
#                 %%%%%     ##             %%%%%   # #                         #
#                 %%%%%%% ##               %%%%%    #                          #
#                 %%%%% %  # #              %%%%%% ##                  #  #    #
#   # #           % %%% %                  %% %%%%                      ##     #
#   ##            %%%% %                   %%%%%%                       #      #
#    #                  %                    %%% %                   ###       #
#  #                                                            %%%%#  #       #
# ##  #  #  ##                                                 %%% %# ##       #
#            #         # # #       # #                         %%%%%%          #
#                      #            #   ##  #                  %%%%%           #
#            #                                                 %%%%%           #
#                         #                 #                    #%%%%         #
#                       ##        #     ### #                                  #
#                                      # ##                                    #
#                                     # #                                      #
#                                                                              #
#                                     #                                        #
################################################################################