    #####
    #   #
    #   #
  ###   ##
  #      #
### # ## #   ######
#@  # ## ##### &  #
#+                #
##### ### # ##   %#
    #%    #########
    #######