################################################################################
#                                                                              #
#                                                                       # #    #
# @             ## #                                              # ##    #    #
#                     #            #                               ###         #
#               ##   ###           ###     # ##                    # #         #
#                     # #          ###     #  #                                #
#                                          #   ##                              #
#                                            ## #                              #
#                                    #     # #                                 #
#                                  ## #      #                         ####    #
#                                   ###     ##                            #    #
#                      #             ##          ##                    #  #    #
#                    # #                           #                           #
#                    # ##                       ###                            #
#                                                                              #
#           #                                                                  #
#        ##          #         ###        # ##                                 #
#        #            ### #               # #                                  #
#                     ## #                 #                                   #
#                      ##                                                      #
#                         #                                                    #
#                       # ##                                   ##              #
#                        # #                                  ###  ###         #
#                                                              ##              #
#                                                                   #          #
#                 #                                                            #
#               ##        #                                                    #
#                         #                                                    #
#         #                                                                    #
#       #                 ## #                                                 #
#        #                  #               #                                  #
#                            #   ## #       ####                               #
#                     ###        #  #       #  #                          ##   #
#                                 ####  ####    #         # #  ##         #    #
#                                     #   #   ####          #  ###       #     #
#                                  #  # ## #  ##               ##              #
#                                                                              #
################################################################################